----+--+--+------------
|         |  +        -
+   +--+  +           -
-      |     *--- --- -
+   +  +--+  +  z z - -
|   |     |  *zzz zz- -
+  -+--+  +           -
|  |xyx|     +zzz zz- -
+  +   +  +**+--z z-- -
-      |              -
----+--+--+**----------
