----+--+--+------------
|         |  +        -
+   +--+  +           -
-      |     *--- --- -
+   +  +--+  +  5 5 - -
|   |     |  *555 55- -
+  -+--+  +           -
|  |121|     +555 55- -
+  +   +  +**+--5 5-- -
-      |              -
----+--+--+**----------
