+--+--+--+--+
|        *  |
+  +--+  +  +
|     |     *
+  +  +--+  +
|  |     |  *
+  +--+  +  +
|  |  |     *
+  +  +  +**+
|     |     g
+--+--+--+**+