----+--+--+--xxxxxxxxx-
|         |         .y-
+   +--+  +  xxxxxxxxx-
-      |  |  -*--------
+   +- +--+           -
|   |-    |  *zzzzzz- -
+  -+--+--+--*        -
|  |   |     +zzz zz- -
+  + | +  +**+--z zz- -
-    |                -
----+--+--+**----------
