----+--+--+------------
|      |     *     |  -
+   +  +  +     |     -
-   |     |  -*--------
+   +- +--+           -
|         |  *zzz zzx x
+  -+--+--+--*      x x
|  |   |     +zzz zzx x
+  + | +  +**+--z zzx x
-    |              x.x
----+--+--+**--------y-
